Magdaline		DARKO	9-Apr
Hephzibah Louise	Mawulom	GAMELI-KWAME	16-Apr
Adomba	Awuraa Adwoa	MORGAN-ASIEDU	2-Apr
Ewuraa Akua	Agyeiwaa	YEBOAH-ASARE	25-Apr
Alexander Louis	Etor	GAMELI-KWAME	16-Apr
Lucky		PONCHANK	14-Apr
Flavia		NANSASI	10-Apr
Nicole	Adutwumwaa	ASENSO-BOAKYE	17-Apr
Senam	Aku	DZAKPASU	26-Apr
Joy	Nanrup	VENKUR	14-Apr
Princess	Adeshewa	AYOADE	26-Apr
Ayeyi	Ekua Egyirwa	BAAH	12-Apr
Doris		MWIHAKI	22-Apr
Ahmed	Shekemal	ABASIMEL	16-Apr
Selorm	Siisi	AKO	9-Apr
Chloe	Elinam	MAWUENYEGA	1-Apr
Liti		MUKAYA	28-Apr
Ruth		NAMIREMBE	7-Apr
Stephanie	Sena Adzo	AMOA	5-Apr
Sally	Adom	AMONOO-MENSAH	22-Apr
Margaret		WANGARE	13-Apr
Trevor	Alexander	CANFOR-DUMAS	16-Apr
Kwasi	Nketsia	AFRIFA	27-Apr
Frederick	Kwesi	FRIMPONG-MENSAH	17-Apr