Kwaku	Addo	ADDO-KUFUOR	19-Sep
Korpo	Ola	FREEMAN	13-Sep
Afua	Amene	LOKKO	28-Sep
Jesse	Kwaku Kyere	NKANSAH	19-Sep
Jayden Samson	Kofi Acheampong	BOAFO	29-Sep
Jake Christopher	Kwaku Kankam	DARKOH	19-Sep
Cedric		IRANKUNDA	9-Sep
Sena	Kofi Adom	OHENE	8-Sep
Kwaku	Gyewuhene-Bona	SIRIBOE	12-Sep
Sandrine		NIYONKURU	16-Sep
Barimah	Yaw Owusu	TWENEBOAH-KODUAH	16-Sep
Lidiya	Tariku	GEMTA	5-Sep
Elizabeth-Ann	Yarley	MENSA	21-Sep
Edith	Dede	ACCAM	3-Sep
Samuel	Tetteh	AYITEVIE	15-Sep
Fafali	Ami	GODZI	17-Sep
Selorm Comfort	Kokui Esi	MORTOTI	24-Sep
Israel		TAMAKA	7-Sep
Nunar	Abui	TAMAKLOE	25-Sep
Darlene	Delasie	BARTH	21-Sep
Mafeng		PAM	9-Sep
Theresa	Maame Serwaa	AKWASI KUMA	24-Sep
Innocente		NISHIMWE	11-Sep
Bijou	Mawuena	ADADEVOH	29-Sep
Ikechukwu	Franklyn	ALFRED	8-Sep
Sean	Kojo	BAWUAH	27-Sep